const short map1_map[10][10] = {
{ 4, 4, 4, 3, 3, 3, 3, 3, 3, 3 },
{ 4, 4, 4, 3, 2, 2, 1, 1, 3, 3 },
{ 4, 4, 2, 2, 2, 2, 1, 1, 3, 3 },
{ 4, 2, 2, 2, 1, 1, 1, 1, 1, 1 },
{ 4, 2, 2, 1, 1, 1, 1, 1, 1, 3 },
{ 3, 2, 2, 2, 1, 1, 1, 1, 3, 3 },
{ 3, 3, 3, 2, 2, 2, 2, 3, 3, 3 },
{ 4, 3, 3, 3, 3, 3, 3, 3, 3, 4 },
{ 4, 4, 3, 3, 3, 3, 4, 4, 4, 4 },
{ 4, 4, 4, 4, 4, 4, 4, 4, 4, 4 }
};
